"baby_stroller","bag","bathtub","blinds","blinds_1","blinds_2","box","box_1","box_2","box_3","box_4","box_5","ceiling","chair","chair_1","chair_2","crib","shelf","stuffed_toy","table","toyhouse","tv","wall","wall_1"
1,1,0,1,1,1,1,0,0,0,0,0,0,1,0,0,1,0,0,1,1,1,0,0
1,0,0,1,1,1,1,1,1,0,0,0,0,1,1,0,1,1,1,0,1,0,0,0
1,0,0,1,0,0,1,1,1,1,1,1,0,1,0,0,0,1,0,0,1,0,0,0
0,0,0,0,0,0,1,1,1,1,1,0,1,1,1,1,0,0,0,0,0,0,1,1
0,0,1,0,0,0,1,1,1,1,1,0,0,0,0,0,1,0,0,0,0,1,1,1
