"armchair","armchair_1","atm","bicycle","book","book_1","books","books_1","candle","car","car_1","car_2","car_3","chair","chair_1","chair_10","chair_11","chair_2","chair_3","chair_4","chair_5","chair_6","chair_7","chair_8","chair_9","chandelier","chandelier_1","chandelier_10","chandelier_11","chandelier_12","chandelier_13","chandelier_14","chandelier_15","chandelier_16","chandelier_17","chandelier_18","chandelier_2","chandelier_3","chandelier_4","chandelier_5","chandelier_6","chandelier_7","chandelier_8","chandelier_9","clock","coffee_table","coffee_table_1","column","cup","cup_1","cup_10","cup_11","cup_12","cup_13","cup_14","cup_15","cup_16","cup_17","cup_18","cup_19","cup_2","cup_20","cup_21","cup_22","cup_23","cup_24","cup_25","cup_26","cup_27","cup_28","cup_29","cup_3","cup_4","cup_5","cup_6","cup_7","cup_8","cup_9","curtain","curtain_1","curtain_2","curtain_3","curtain_4","curtain_5","curtain_6","dining_table","door","dresser","dresser_1","fence","fence_1","fence_2","fence_3","fireplace","fireplace_1","fish_tank","floor_lamp","glass","glass_1","glass_10","glass_11","glass_12","glass_13","glass_14","glass_15","glass_16","glass_17","glass_18","glass_19","glass_2","glass_20","glass_21","glass_22","glass_23","glass_24","glass_25","glass_26","glass_27","glass_28","glass_29","glass_3","glass_4","glass_5","glass_6","glass_7","glass_8","glass_9","ipad","kitchen_set","magazines","mirror","motorcycle","motorcycle_1","motorcycle_2","motorcycle_3","motorcycle_4","ottoman","ottoman_1","ottoman_2","person","person_1","person_2","piano","picture_frame","picture_frame_1","picture_frame_2","picture_frame_3","picture_frame_4","picture_frame_5","picture_frame_6","picture_frame_7","pillow","pillow_1","pillow_2","pillow_3","pillow_4","plant","plant_1","plant_2","plant_3","plant_4","plates","plates_1","plates_10","plates_11","plates_12","plates_13","plates_14","plates_15","plates_16","plates_17","plates_2","plates_3","plates_4","plates_5","plates_6","plates_7","plates_8","plates_9","playstation","refrigerator","rug","rug_1","rug_10","rug_2","rug_3","rug_4","rug_5","rug_6","rug_7","rug_8","rug_9","shelving","shelving_1","shelving_2","shelving_3","shelving_4","shelving_5","sink","sofa","sofa_1","sofa_2","sofa_3","stairs","stairs_1","table_lamp","telephone","television","television_1","toy","toy_1","trinket","tv_stand","tv_stand_1","vase","wall_lamp","wall_lamp_1","wardrobe_cabinet","wardrobe_cabinet_1","wardrobe_cabinet_2","window","window_1","window_2","window_3","window_4","window_5","window_6","window_7","window_8"
1,0,0,0,0,0,0,0,1,1,1,1,1,1,1,0,0,1,1,0,0,0,0,0,0,0,0,0,0,0,0,0,0,0,0,0,0,0,0,0,0,0,0,0,0,1,0,0,0,0,0,0,0,0,0,0,0,0,0,0,0,0,0,0,0,0,0,0,0,0,0,0,0,0,0,0,0,0,0,0,0,0,0,0,0,1,1,0,0,0,0,0,0,0,0,0,0,0,0,0,0,0,0,0,0,0,0,0,0,0,0,0,0,0,0,0,0,0,0,0,0,0,0,0,0,0,0,0,0,0,0,0,0,0,0,0,0,0,0,1,0,0,0,1,0,0,0,0,0,0,0,0,0,0,0,0,0,0,0,0,0,0,0,0,0,0,0,0,0,0,0,0,0,0,0,0,0,0,0,0,0,1,1,0,0,0,0,0,0,0,0,0,0,0,0,0,0,0,0,1,0,0,0,0,0,0,0,1,0,0,0,0,1,0,1,0,0,1,0,0,1,1,1,0,0,0,0,0,0
1,1,0,0,0,0,0,0,0,1,0,0,0,1,1,0,0,1,0,0,0,0,0,0,0,1,0,0,0,0,0,0,0,0,0,0,0,0,0,0,0,0,0,0,0,1,0,0,0,0,0,0,0,0,0,0,0,0,0,0,0,0,0,0,0,0,0,0,0,0,0,0,0,0,0,0,0,0,0,0,0,0,0,0,0,1,1,0,0,1,1,1,1,1,0,0,0,0,0,0,0,0,0,0,0,0,0,0,0,0,0,0,0,0,0,0,0,0,0,0,0,0,0,0,0,0,0,0,0,0,1,0,0,0,0,0,0,0,0,0,0,0,0,0,0,0,0,0,0,0,0,0,0,0,0,0,0,0,0,0,0,0,0,0,0,0,0,0,0,0,0,0,0,0,0,0,0,0,0,0,0,0,0,0,0,0,0,0,0,0,0,0,0,0,0,0,0,0,1,1,0,0,0,1,1,0,0,0,0,0,0,0,0,0,0,1,1,0,0,0,0,0,0,0,0,0,0,0,0
0,0,0,0,1,1,0,0,0,1,1,0,0,1,1,0,0,1,1,0,0,0,0,0,0,1,1,0,0,0,0,0,0,0,0,0,0,0,0,0,0,0,0,0,1,1,0,0,0,0,0,0,0,0,0,0,0,0,0,0,0,0,0,0,0,0,0,0,0,0,0,0,0,0,0,0,0,0,0,0,0,0,0,0,0,1,0,0,0,0,0,0,0,0,0,1,1,0,0,0,0,0,0,0,0,0,0,0,0,0,0,0,0,0,0,0,0,0,0,0,0,0,0,0,0,0,0,0,1,0,0,0,0,0,0,0,0,0,0,0,0,0,0,1,0,0,0,0,0,0,0,1,1,1,0,0,1,1,1,1,1,0,0,0,0,0,0,0,0,0,0,0,0,0,0,0,0,0,0,0,0,1,1,1,1,1,1,1,1,1,1,1,1,1,0,0,0,0,0,1,1,0,0,0,0,1,0,1,0,1,1,0,0,0,0,0,0,0,0,0,1,1,1,0,0,0,0,0,0
1,1,0,0,1,0,0,0,1,0,0,0,0,1,1,1,1,1,1,1,1,1,1,1,1,0,0,0,0,0,0,0,0,0,0,0,0,0,0,0,0,0,0,0,0,1,1,0,1,1,1,1,1,1,1,1,1,1,1,1,1,1,1,1,1,1,1,1,1,1,1,1,1,1,1,1,1,1,1,1,1,1,1,1,1,1,1,0,0,0,0,0,0,1,1,0,0,1,1,1,1,1,1,1,1,1,1,1,1,1,1,1,1,1,1,1,1,1,1,1,1,1,1,1,1,1,1,1,1,1,1,1,1,1,1,1,1,0,0,0,0,0,1,0,0,0,0,0,0,0,0,0,0,0,0,0,1,1,0,0,0,1,1,1,1,1,1,1,1,1,1,1,1,1,1,1,1,1,1,1,0,0,0,0,0,0,0,0,0,0,0,0,1,0,0,0,0,0,0,1,1,1,1,0,0,0,1,1,1,0,0,1,1,0,1,0,0,1,0,0,1,1,1,1,1,1,1,1,1
0,0,1,0,0,0,1,1,1,1,1,0,0,1,1,0,0,1,1,1,1,0,0,0,0,1,0,0,0,0,0,0,0,0,0,0,0,0,0,0,0,0,0,0,0,1,0,1,0,0,0,0,0,0,0,0,0,0,0,0,0,0,0,0,0,0,0,0,0,0,0,0,0,0,0,0,0,0,1,1,0,0,0,0,0,1,0,0,0,0,0,0,0,1,0,0,1,0,0,0,0,0,0,0,0,0,0,0,0,0,0,0,0,0,0,0,0,0,0,0,0,0,0,0,0,0,0,0,0,0,0,1,1,1,0,0,1,1,1,1,1,1,1,1,1,1,1,1,1,1,1,0,0,0,0,0,0,0,0,0,0,0,0,0,0,0,0,0,0,0,0,0,0,0,0,0,0,0,0,1,0,1,1,0,1,0,0,0,0,0,0,0,0,0,0,0,0,0,0,1,0,0,0,0,0,0,0,1,0,1,0,0,1,1,1,1,1,1,1,1,0,0,0,0,0,0,0,0,0
1,0,0,1,0,0,0,0,0,0,0,0,0,1,1,0,0,1,1,0,0,0,0,0,0,1,1,1,1,1,1,1,1,1,1,1,1,1,1,1,1,1,1,1,0,1,0,0,0,0,0,0,0,0,0,0,0,0,0,0,0,0,0,0,0,0,0,0,0,0,0,0,0,0,0,0,0,0,1,1,1,1,1,1,0,1,1,1,1,0,0,0,0,0,0,0,1,0,0,0,0,0,0,0,0,0,0,0,0,0,0,0,0,0,0,0,0,0,0,0,0,0,0,0,0,0,0,0,1,0,0,0,0,0,0,0,0,0,0,1,0,0,0,0,0,0,0,0,0,0,0,1,1,1,1,1,0,0,0,0,0,0,0,0,0,0,0,0,0,0,0,0,0,0,0,0,0,0,0,0,1,1,0,0,0,0,0,0,0,0,0,0,1,1,1,1,1,1,0,1,0,0,0,0,0,0,0,1,0,0,0,0,0,0,0,0,0,0,0,0,1,1,0,0,0,0,0,0,0
